一	一
三	三
上	上
下	下
不	不
与	與
且	且
两	兩
个	個
中	中
临	臨
为	為
主	主
久	久
么	麼
义	義
之	之
也	也
了	了
予	予
事	事
二	二
于	於
五	五
些	些
交	交
人	人
什	什
仅	僅
仍	仍
从	從
他	他
代	代
以	以
们	們
件	件
任	任
会	會
但	但
位	位
住	住
体	體
何	何
作	作
你	你
使	使
例	例
侵	侵
便	便
保	保
信	信
修	修
候	候
值	值
做	做
停	停
像	像
允	允
先	先
免	免
入	入
全	全
六	六
关	關
其	其
具	具
典	典
内	內
册	冊
再	再
写	寫
冲	衝
决	決
况	況
准	準
凡	凡
出	出
击	擊
分	分
列	列
则	則
刚	剛
创	創
删	刪
别	別
到	到
制	★製制
刷	刷
前	前
功	功
加	加
务	務
动	動
助	助
勾	勾
勿	勿
包	包
化	化
区	區
匿	匿
协	協
单	單
即	即
却	卻
历	歷
原	原
去	去
参	參
及	及
反	反
发	發
取	取
变	變
口	口
另	另
只	只
可	可
台	台
史	史
右	右
号	號
合	合
同	同
名	名
后	後
向	向
否	否
含	含
启	啟
告	告
员	員
味	味
命	命
和	和
响	響
器	器
四	四
回	回
因	因
固	固
国	國
图	圖
在	在
地	地
圾	圾
址	址
坐	坐
垃	垃
基	基
填	填
增	增
声	聲
处	處
备	備
复	複
外	外
多	多
大	大
太	太
失	失
如	如
始	始
委	委
子	子
字	字
存	存
它	它
安	安
完	完
定	定
实	實
家	家
容	容
密	密
对	對
导	導
将	將
小	小
少	少
尚	尚
尝	嘗
就	就
展	展
属	屬
工	工
左	左
已	已
布	布
帐	帳
帮	幫
常	常
年	年
并	★併並
序	序
库	庫
应	應
建	建
开	開
异	異
式	式
引	引
当	當
录	錄
形	形
影	影
待	待
很	很
循	循
必	必
志	誌
忘	忘
态	態
息	息
您	您
情	情
想	想
意	意
成	成
我	我
或	或
截	截
户	戶
所	所
手	手
才	才
打	打
执	執
批	批
找	找
承	承
护	護
报	報
抹	抹
择	擇
拼	拼
持	持
指	指
按	按
换	換
据	據
排	排
接	接
提	提
搜	搜
摘	摘
擅	擅
支	支
收	收
改	改
放	放
政	政
效	效
教	教
数	數
整	整
文	文
新	新
方	方
无	無
日	日
旦	旦
旧	舊
早	早
时	時
明	明
星	星
映	映
是	是
显	顯
更	更
替	替
最	最
月	月
有	有
服	服
期	期
未	未
本	本
机	機
权	權
条	條
来	來
果	果
某	某
查	查
标	標
栏	欄
样	樣
根	根
格	格
框	框
档	檔
检	檢
検	検
横	橫
橋	橋
次	次
欢	歡
止	止
正	正
此	此
殊	殊
母	母
每	每
比	比
毕	畢
永	永
求	求
汉	漢
沙	沙
没	沒
法	法
注	★註注
洞	洞
测	測
浏	瀏
消	消
添	添
清	清
湾	灣
源	源
滥	濫
漏	漏
点	點
照	照
片	片
版	版
物	物
特	特
犯	犯
状	狀
独	獨
率	率
现	現
理	理
生	生
用	用
由	由
申	申
电	電
略	略
番	番
登	登
百	百
的	的
盒	盒
目	目
直	直
相	相
省	省
看	看
着	著
知	知
短	短
码	碼
破	破
确	確
示	示
禁	禁
私	私
科	科
程	程
稍	稍
空	空
突	突
窗	窗
立	立
章	章
符	符
第	第
等	等
策	策
管	管
箱	箱
篇	篇
籍	籍
系	係
索	索
约	約
纵	縱
组	組
细	細
终	終
经	經
结	結
给	給
绝	絕
统	統
继	繼
续	續
维	維
缀	綴
缓	緩
编	編
网	網
置	置
署	署
老	老
考	考
者	者
而	而
联	聯
能	能
自	自
至	至
致	致
航	航
节	節
英	英
范	範
荷	荷
著	著
藏	藏
虑	慮
行	行
表	表
被	被
装	裝
要	要
见	見
规	規
视	視
览	覽
解	解
言	言
諸	諸
警	警
订	訂
认	認
讨	討
让	讓
议	議
记	記
许	許
论	論
设	設
证	證
试	試
话	話
该	該
详	詳
语	語
误	誤
说	說
请	請
读	讀
调	調
象	象
负	負
责	責
败	敗
账	賬
起	起
超	超
轍	轍
转	轉
载	載
较	較
辑	輯
输	輸
辞	辭
边	邊
过	過
迎	迎
近	近
返	返
还	還
这	這
进	進
述	述
退	退
送	送
选	選
通	通
遵	遵
避	避
那	那
邮	郵
部	部
都	都
里	裡
重	重
量	量
钟	鐘
钮	鈕
链	鏈
错	錯
键	鍵
问	問
间	間
阅	閱
防	防
际	際
限	限
除	除
随	隨
隐	隱
集	集
零	零
需	需
非	非
面	面
页	頁
项	項
顺	順
须	須
预	預
题	題
首	首
验	驗
高	高
默	默
础	礎
占	佔
“	「
”	」
操	操
得	得
